####################################
I # ############################## #
#                                # #
#### ############# ############# # #
#### ############# ############# # #
####         #####         ##### # #
############ ####  ############# # #
############ #### ##         ##### #
####            # ## ####### ##### #
#### ####### #### ## ##  ### ##    #
#### ####### #    ## ###  ## ## ####
#### ############### #### ## ## ####
####                   ## ## ##    #
# ##### ###### #### ###    # ##### #
#     # ###### #### ### #### ##### #
# #####           ##### ####       #
# ##################### ######## ###
################################   O
